S#########
*********#
########*#
#******#*#
#*####*#*#
#*#**M*#*#
#*#****#*#
#*######*#
#********#
##########

58