###########
#**########
######*####
###S##*####
####***####
####*#M####
#**#*######
####***####
###########
####*######

11